0 0 0  0
1 1 0  0
2 2 0  0
10 0 1 0
11 1 1 0
12 2 1 0
20 0 2 0
21 1 2 0
22 2 2 0
30 0 3 0
31 1 3 0
32 2 3 0